11111111111111111111111111111111111
1110101C000P0000E00000100000E000001
101C10000110000000000000000C0000001
100000C00010001000000000010000000C1
1C0011100001100100C01011100100C0101
11111111111111111111111111111111111