11111111111111111111111111111111111
1110101C00010000E00000100000E000001
101C10000110000000000000000C0000001
100000C00010001000000000010000000C1
1C0011100001100000C00011100100C0101
1000000000C00P000000000000C0000C001
100001100000011000C000000000000C111
100000C00010001000001000010000000C1
11111111111111111111111111111111111
